1 1 1 1 1
1 1 0 0 f
1 1 0 1 1
c 0 0 1 1
1 1 1 1 1